NO jsp.xpm
SO tex.xpm
										EA ./path_to_the_east_texture.xpm
			WE ./path_to_the_west_texture.xpm

F 25242,100
C 251,30,0

		   1111111111111111111111111
		   1000000000110000000000001
		   1011000001110000000000001
		   1001000000000000000000001
111111111011000001110000000000001
100000000011000001110111111111111
11110111111111011100000010001
111101111111110N1101010010001
1100000011010101 1100000010001
10000000000000001100000010001
1000000 0000000001101010010001
110000011101010111110111100111
11110111 1110101 101111010001
11111111 1111111 111111111111