
NO 			./textures/n.xpm
         SO ./textures/s.xpm
WE ./textures/w.xpm

EA ./textures/e.xpm

F 60, 42, 33
C 134, 229, 255
 

        1111111111111111111111111
        1000000000110000000000001
        1011000001110000000000001
        1001000000000000000000001
111111111011000001110000000000001
100000000011000001110111111111111
11110111111111011100000010001
111101111111111011101010010001
11000000110101011100000010001
10000000000000001100000000001
1000000000000W00001010010001
110000011101011101111001111
11110111 1110101001111010001
1111111111111111111111111111