
NO 			./textures/n.xpm
         SO ./textures/s.xpm


WE   	./textures/w.xpm
		EA ./textures/e.xpm

F 60, 5,55

C 			20,2,100

 

        1111111111111111111111111
        1000000000110000000000001
        1011000001110000000000001
        1001000000000000000000001
111111111011000001110000000000001
100000000011000001110111111111111
11110111111111011100000010001
111101111111111011101010010001
11000000110101011100000010001
100000001 1000001100000000001
100000001 10000W000010100100011
11000001110101110111100111111
11110111 1110101001111010001
1111111111111111111111111111