111111111111111
100000000000101
100101000000101
101110000010101
100000000010101
100000001111101
1000000S0000001
100000000000001
111111000111101
100000000000001
111111111111111