11111111111111111111
10000000000000000001
10000000000000000001
10001010101010101001
10000000000000000001
10000000000000008001
10000000000000001001
10000110000000001001
10001000000001110001
10000000000000000001
10000000000000000001
1000000000000000N001
11111111111111111111